gene	actionable_type
FGFR2	fusion
FGFR2	point
BRCA1	point
BRCA2	point
KRAS	point
IDH1	point
IDH2	point
MDM2	CNV
ERBB2	CNV
ERBB2	point
BRAF	point
MET	CNV
MSI	HIGH
CCNE1	CNV
MTAP	CNV
NTRK1	fusion
NTRK2	fusion
NTRK3	fusion
RET	fusion
RET	CNV
NRG1	fusion